################
#..............#
#........#############
#........#.....#.....#
#........+.....+.....#
#........#.....#.....#
#........#############
#..............#
#..............#
#........#######
#........#.....#
#........=.....#
#........#.....#
#........#######
#..............#
################